##...%####.#.#*...#.
...######^...##.^.#.
#........$.#.####.##
..$.#....#.####.....
#.#.#.#.#.......#.#.
^....###....#..###^.
###....#...#...#*...
#########.##########
#....#.....#...^..#.
##.###.......$..#..#
##....#..##..#..#..#
.^.#.#####...#....##
#....#..####.....#..
..^....$..........^.
..#......##...####..
#.########.##....##.
#.....^#######..^..#
..^.####....###....#
###....$....#..###..
####.....*###...###@