@....#.......#..##..
.....#.^.##..#...$...
..^.##..###..#..*#..
...#.###........^.##
..###....$..........
............^.......
####^...#######....#
.....#...$....^......
#..^.....####.###.###
#.#....#..#########.
*..#......#.####...#
##..#..#....#..#....
....#..####.....##..
......^....^....$..#
..^...####.###......
.....#####.....##..#
*###...#...##....###
###......#...####...
######..$.....%^....
#...#....^....#...##