#@..........^..######
#.########....###*##
#..##########.....##
#^.........########.
##########.#########
......$....#########
.#####.####....^####
.#.########.##*.####
......$.....########
#####.##############
####...###.##^....##
#....^.....##..##.##
#.##...###.##.###.##
..###.####.#..###.##
.###########.####.##
.........$...###*.##
#.###.#######...####
#.######......#..###
#.######.#######.%##
#......$.^....######